111111111111
1000C0000001
100000000001
10P00C000001
100000111101
1000C0000E01
111111111111
