11111111111111111
1000C0000000000E1
1P000000111111111
111111111
