11111111111
1P00C0000E1
1P00C0000E1
11111111111