111111111111
1000C0000001
1000c0000001
10P00C000001
1000d0111101
1000C0000E01
111111111111
