111111111111111111
1100000000C0000011
1P1000000011111111
1E1000000000000001
111111111111111111