111111111111111111
1000000001C0000011
1P0000000011111111
1E0000000000000001
111111111111111111