111111111111111111
1P00000000C0000011
111000000011111111
1E1000000000000001
111111111111111111