111111111111111111
1P10000000C0000011
110000000011111111
1E0000000000000001
111111111111111111