11111111111
10E00010001
11000C00P01
11111111111
