11111111111
1P0000000E1
11111111111