11111111111
11000010001
11000C00P01
11111111111
