11111111111111111111111111111111111111111
11111111111111111111111111111111111111111
1100000000000000000000000C000010001000C11
1100000000000000000010000C000010101011011
11111111111111111001110001111C10101C01011
11111111P1110000001111100100C010101101011
11000000000001111111111111011110100001011
110000000000111111111111110C0000111111E11
11111111111111111111111111111111111111111
11111111111111111111111111111111111111111
