11111111111111
1PCCCCCCCCCCE1
11111111111111
