111111111111111
1111111111111P1
100000000000001
101111111111111
100000000000001
111111111111101
100000000000001
101111111111111
100000000000001
111111111111101
100000C00000001
101111111111111
100000C00000001
111111111111101
100000C00000001
101111111111111
100000C00000001
111111111111101
100000C00000001
101111111111111
100000000000001
111111111111101
100000000000001
1E1111111111111
111111111111111